#####
#  X#
# UU# ###
# U # #*#
### ###*#
  #    *#
 #   #  #
 #   ####
 #####