          #
         # #
        # # #
       #  *  #
      # O U O #
     #  # U #  #
    #   # # #   #
   #   *O * O*   #
  # O##O  #  O##O #
 #                 #
# #OUU#*# X #*#UUO# #
 #                 #
  # O##O  #  O##O #
   #   *O * O*   #
    #   # # #   #
     #  # U #  #
      # O U O #
       #  O  #
        # # #
         # #
          #