#### ####
#  ###  #
# U O U #
#   *X  #
### *U###
  # * #
  #####