  #####
###   ##
#  U#  #
#  *X*U##
##*# #  #
 # U    #
 ##  ####
  ####