#################
#  #  #  #  #   #
#*U   #  #      #
#  #*U *U   #   #
# X#  #  #  #   #
#################