 #####
 #   ###
## #U X#
# * U  #
#***#U##
# #  U #
#  #   #
##   ###
 #####