 #######
 #  #  #
 #UX* U#
 # *#* #
##U*#*U##
# U * U #
#   #   #
#########