   ####
####  #
#  U  ##
# #U#  #
#  U   #
#*###  #
#*#### #
#* X   #
########