  #####
###   #
# U # ##
# #  * #
#    # #
## #   #
 #X  ###
 #####