 #####
##   ###
# * * *#
# # ## ##
#    UUX#
### # U #
  #   ###
  #####