##########
######   #
## U * # #
## # UU  #
## ## # ##
#  U*U* ##
# ##   ###
#  *X*####
##########