   #####
 ###   #
##     #
# OOO ##
#  OX #
# *OU##
##   #
 ##  #
  ####