 #####
 #   ##
## O *##
# UUO  #
#  O * #
## X ###
 #####